╶─┬───┬───────────┬───────┬─┬───────┬─────┐
 🍒│   │  🐍 🍌     🐍│🍒   🍌 🍌│ │🐍      │    🍌│
╷ │ ╷ │ ┌─┬─────┐ ╵ ┌───┐ │ │ ┌───┐ ╵ ╷ ╶─┤
│🍒│ │ │ │🍌│     │🍌 🍒│   │ │🐍│ │🍌  │🐍 🍒│🍒  │
│ ╵ │ │ │ ╵ ╷ ┌─┴───┘ ┌─┘ │ ╵ │ ╷ └───┼─╴ │
│🍒  │ │🍒│█ █│█│█ █ █ █│█ █│█ █│█│🍌 🍌  │   │
├───┤ ╵ │ ╶─┤ ╵ ┌───╴ │ ┌─┘ ╶─┴─┘ ╷ ┌─┘ ╷ │
│   │  🐍│█ █│█ █│█ █ █│█│█ █ █ █  │🍌│   │ │
│ ╷ └───┼───┴─┐ │ ╶───┤ └─┬─────┬─┘ │ ┌─┘ │
│ │     │█ █ █│█│🐍   🍌│  █│█ █ █│  🐍│ │  🍒│
│ ├───┐ │ ┌─╴ │ ├───╴ └─┐ ╵ ┌─╴ │ ╶─┤ └───┤
│ │🐍 🍒│ │█│█ █│█│  🐍   🐍│█ █│█ █│  🍌│🍒 🐍 🐍│
│ │ ╷ ╵ ╵ │ ╶─┴─┘ ┌─╴ ┌─┴───┤ ┌─┴─┐ ├───┐ │
│ │🍌│  🐍 █│█ █ █ █│█ █│█ █ █│█│█  │🍒│🐍 🐍│🍌│
│ └─┴─┬───┴─────┬─┘ ┌─┤ ╷ ╷ │ │ ╷ ╵ │ ╷ │ │
│🍌    │🐍 █ █ █ █│█ █│█│█│█│█│█│█│🐍  │ │ │🐍│
├───╴ │ ╶─┐ ┌─╴ │ ╶─┤ │ │ └─┘ │ └───┴─┘ │ │
│  🐍  │  █│█│█ █│🍌 🐍│ │ │  🐍  │        🐍│ │
│ ╶─┬─┴─┐ │ ├───┼─╴ ╵ │ ├─────┘ ┌───┬─╴ │ │
│🐍 🍒│🍌 🍌│█│█│█ █│    🍒│🐍│       │  🍒│   │ │
├─╴ │ ┌─┘ │ ╵ ╷ ╵ ┌───┘ │ ╶───┬─┘ ╷ └───┘ │
│🍌  │🍒│🍒 █│█ █│█  │🍒 🍒 🐍│🍒    │   │    🍌  │
│ ┌─┘ ╵ ╶─┴───┴─┬─┘ ┌───┴───┐ │ ┌─┴───┬─╴ │
│ │🐍 🐍   █ █ █ █│🍒 🍒│    🐍  │ │ │🍒 🍌 🐍│🐍  │
│ │ ┌─────────┐ │ ╶─┤ ╶───┐ └─┘ │ ┌───┤ ╶─┤
│🍒│ │🍒 🐍   🍌 🍌│🍒│  🍌│🍒 🐍  │     │🍌│  🍌│🍌 🍌│
│ └─┤ ╶─┬───┐ └─┴─┐ └───┐ └───┬─┘ │ ╷ └─╴ │
│  🐍│   │🍌  │🍌 🍒  │     │🐍 🐍 🍒│  🍌│🐍│🍒   🍒│
├─╴ └─┐ ├─╴ └─┐ ╶─┴─┬─┐ ├───╴ │ ╷ │ └─────┤
│  🍒  │🍒│█ █ █│█ 🍒 🐍│ │🐍│█ █ █│█│ │  🍌 🐍 🍒│
│ ┌───┘ ╵ ┌─╴ └─┐ ╷ │ │ ╵ ┌───┘ │ └─┬───╴ │
│ │  🍌 🐍 █│█ █ █│ │🍒│🍒│  █│█ █ █│   │🍌    │
│ │ ┌───┬─┴───┬─┘ │ ╵ ├───┴───╴ ├─╴ │ ┌───┤
│🐍│ │  🍌│█ █ █│█ 🍒│🍒 🐍│  █ █ █ █│   │🍌│  🍒│
│ ╵ │ ╶─┤ ╶─┐ ╵ ┌─┴─┐ └─╴ ┌───┐ ├───┤ │ ╷ │
│  🍒│🍌 🐍│█ █│█ █│   │🍒 🍒 █│█ █│█│  🍌│🍌│ │ │
│ ┌─┘ ╷ └─┐ ├─┬─┘ ╷ └─────┤ ╷ ╵ │ ╷ ╵ │ └─┤
│ │🐍 🍒│  █│█│█│█ █│█ █ █ █│█│█ █│ │   │  🍌│
│ ├───┘ ┌─┘ │ │ ┌─┴─────┐ ╵ ├───┘ ├───┴─┐ │
│🍌│     │█ █│█│█│█ █ █ █│█ █│█ █ 🍌│🐍    │🐍│
│ ╵ ┌─╴ │ ┌─┘ │ └───╴ ╷ └───┤ ┌───┘ ┌─╴ │ │
│  🍒│   │🍒│🐍  │  █ █ █│█    │🍒│🍒 🍒  │🍌  │🍌│
├─┬─┘ ┌─┘ │ ╷ └───┐ ┌─┴─┬───┘ │ ┌───┤ ┌─┘ │
│🍒│🍒  │🍌  │🍒│  🐍 █│█│█ █│🍒 🍌  │🐍│🍌 🍌│🍌│   │
│ │ ┌─┤ ╶─┤ └───┐ │ │ ╷ │ ╶─┬─┘ │ ╶─┘ ╵ ╷ │
│ │ │🐍│   │    🐍│█│█│█│█│🍒  │🐍 🐍│🐍 🍌    │🍒│
│ │ │ ├─╴ ├───┐ │ │ │ │ └─╴ │ ╶─┼───┬───┴─┤
│🐍│🐍│🐍│🐍  │🐍 🐍│🍌│█│█│█│█   🐍│🍒  │  🍌│🍒    │
│ ╵ ╵ │ ┌─┘ ╷ │ │ ╵ │ ├─────┤ ╷ ╵ ╷ ╵ ╶─┐ │
│  🍌 🐍│ │   │ │🍒│   │🐍│    🍌│ │  🍌│  🐍  │ │
├─────┘ ├───┤ ╵ └─┬─┤ │ ╶─┐ ╵ └───┼─────┤ │
│🍒   🍒 🐍│  🍌│     │ │🍒│🍌  │🍒     🐍│  🐍 🐍│🍌│
│ ╶─┐ ┌─┘ ╷ ├───┐ ╵ │ └─┐ ├───┬───┤ ┌─┐ │ │
│🍌 🍌│🍒│  █│█│█ █│█ █│█ █│█│█ █│█  │ │🍌│🍒│ │
│ ╷ │ │ ┌─┤ ╵ ╷ └─┐ └─┐ │ ╵ ╷ │ ╷ ╵ │ │ ╵ │
│🍒│🍒│ │🍌│█│█ █│█ █│█ █│█│█ █│█│█│🍒 🍌│ │🍌  │
│ │ └─┤ ╵ ├───┴─┐ ├─╴ │ └─┬─┘ │ ├───┘ └─┐ │
│ │🍒 🐍│  █│█ █ █│ │🍌  │🍌  │🍌 🐍│🍒│🍒   🍒 🍒│ │
│ └─┐ └─╴ ╵ ┌───┘ │ ╶─┴─┐ └───┘ │ ╷ ┌───┘ │
│  🍌│🍒   █ █│█ █ 🍌│  🍒  │🍒      │ │ │🍌 🍌  │
├─┐ ├───────┤ ╶───┼─╴ ┌─┴───────┘ │ │ ┌───┤
│🍌│🐍│🍒 🐍 █ █│█ █  │🍒  │🍒 🍒     🍒  │ │🍒│🐍  │
│ │ │ ┌───┐ └─┐ ╷ ├───┘ ╶─────┐ ╶─┤ │ │ ╶─┤
│ │🍌│🍌│🍌 █│█ █│█│ │  🍒 🍒      │  🍌│ │🍒│  🐍│
│ ╵ │ │ ╷ └─┐ └─┤ │ ┌─────┬─┐ ├─┐ └─┤ └─┐ │
│🍒 🍌│🐍│🍌│█ █│█ █│🍌│🍌│    🍒│🐍│ │ │   │🍌 🐍│ │
│ ┌─┘ │ └─┐ └─┐ │ ╵ │ ╶─┐ │ ╵ ╵ └─┐ └─┐ │ │
│ │  🐍│  █│█ █│█│  🐍│   │ │      🐍│🍒  │ │🐍│
├─┘ ╷ ├─╴ ├─╴ │ │ ┌─┴─╴ │ └─────┐ └─┐ │ ╵ │
│   │🍌│  █│█ █│█│█│█ █ █│█ █ █ █│   │🍒│   │
│ ╶─┴─┘ ┌─┘ ┌─┤ ├─┘ ┌───┴─────┐ ├───┤ └─┐ │
│    🍌  │█ █│█│█│█ █│█ █ █ █ █│█│  🍌│🍌 🐍│ │
│ ┌─────┘ ┌─┘ ╵ │ ╶─┴─┐ ╶─────┘ ╵ ╷ ╵ ╷ │ │
│ │🍌     🍒│🍒    │    🐍│      🍒    │🍒  │ │ │
├─┘ ┌─────┘ ╶───┴───┐ │ ┌───┐ ┌───┴───┴─┤ │
│🍒  │          🐍    │🍌│ │🍌 🍌│🐍│🐍     🍒 🐍│🍌│
│ ╶─┴───────────┬─╴ ╵ ├─┘ ╷ └─┤ ┌─────┐ ╵ │
│  🍌     █ █ █ █│█ █ █│█ █│█ █│█│🍒   🍒│   │
│ ╶─┬─┬───────╴ │ ┌─┬─┘ ┌─┴─┐ ╵ │ ╷ ╷ └─┬─┤
│   │🍌│🍒 █ █ █ █│█│█│█ █│█ █│█ █│🍒│🍌│  🐍│🍌│
├─┐ │ │ ╶───┬───┘ ╵ │ ┌─┴─╴ └───┤ │ └─┐ │ │
│ │🐍│🐍│🍌 █ █│█ █ 🍌 🍒│🍒│  █ █ █ █│ │  🍒│ │ │
│ │ ╵ ├───╴ ├───┬─╴ │ │ ┌─────┐ ├─┴─╴ │ ╵ │
│ │  🍌│🍒 █ █│█ █│   │ │🐍│█ █ █│█│  🍌 🐍│🐍 🍌│
│ ├─╴ │ ╶───┘ ╷ └───┘ │ ├─╴ ╷ │ ╵ ┌───┴─┐ │
│🍒│🍒 🐍│  █ █ █│█ 🍒   🐍│🍌│█ █│█│█ 🍒│  🍌 🐍│ │
│ │ ┌─┴─────┬─┴───┬───┘ │ ┌─┘ └───┘ ┌───┤ │
│🍒│🍒│🍒 🍌 █ █│█ █ 🍒│🍒 🍌 🍒│█│█ █ █   🍒│  🍌│🍒│
│ │ │ ╶─┐ ╷ ╵ ┌─╴ ├─╴ ┌─┘ └─────────┤ ╷ │ │
│🐍│🍒│🍒 🍒│█│█ █│█ 🍒│🐍  │🐍 █ █ █ █   🐍│ │🍌│🐍│
│ │ └───┘ ├─┬─┘ ┌─┘ ╶─┴─┐ ┌─────┬─┐ ╵ │ ╵ │
│🍒│🐍 🍌 🍒 █│█│█ █│🍒 🐍    │█│█ █ █│🍌│  🍌│  🐍│
│ └─────┬─┘ │ ╶─┴─────┐ │ └─╴ ╷ │ └───┴───┤
│      🍒│█ █│█ █ █ █ █│█│█ █ █│█│🍌   🍒 🍌  │
│ ╶─┐ ╶─┘ ╷ └─────┬─╴ │ ├─┬───┘ │ ╶───┐ ╶─┤
│🐍 🍌│    █│█ █ █ █│█ █│█│█│█ █ █│🍒   🍌│🍌 🍌│
├─╴ ├─────┼───┐ ╷ │ ╶─┘ │ │ ┌───┴─┬─╴ ├─╴ │
│   │🐍   🍌│🐍 🍌│ │🍌│🍒 🐍  │ │🍒│  🍌  │   │🍒 🍒│
│ ┌─┴─╴ ┌─┘ ╷ ╵ │ └─┬───┘ │ │ ╷ ╶─┤ ╶─┤ ╶─┤
│🐍│  🍒  │🐍 🍒│🍒 🐍│  🐍│  🐍  │ │ │🍒 🍌│🐍 🐍│   │
│ ├─╴ ╷ │ ╷ ├───┴─┐ │ ╷ ╶─┘ │ └─┐ ╵ ┌─┴─┐ │
│🍒│   │ │█│█│█ █ 🍒│🍒│ │  █ █│█ █│   │🍒  │🐍│
│ ╵ ┌─┘ │ └─┤ ┌─┐ ├─┘ ├─────┴───┴───┘ ╷ ╵ │
│🍒  │🍒  │█ █│█│█│ │🐍 🍌│  █ █ █ █   🍒 🍒│  🍒│
├───┤ ┌─┴─┐ ╵ │ │ │ ╶─┴─┐ ╶─────────┬─┴─╴ │
│🐍 🐍│🍒│  █│█ █│█│█│  🍒  │█ █ █ █ 🍌  │     │
│ ╶─┤ └─╴ └───┤ │ ├───┐ └───┐ ╶───┐ └─┐ ╶─┤
│  🐍│🐍 🍒 █ █ █│█│█│█  │  █ █│█ █ 🍌│   │🍌  │
│ ╷ └─────┬─╴ ╵ │ │ ╷ └─┬─╴ ├─╴ ┌─┴─╴ ├─┐ │
│ │      █│█ █ █│█│█│█ █│█ █│█ █│    🍒│🍒│🍒│
│ └─┬─╴ ╷ │ ┌─┬─┘ │ ├─╴ │ ╶─┼───┘ ┌───┤ ╵ │
│  🍌│🐍  │█│█│█│█ █│█│█ █│█ █│█ █  │🍒  │  🐍│
├─┐ │ ╷ ├─┘ │ │ ╶─┘ │ ╶─┴─┐ ╵ ┌───┘ ╷ │ ╶─┤
│ │ │🍒│🍌│█ █│█│█ 🍌  │█ █ █│█ █│█    │🍌│   │
│ ╵ │ └─┤ ┌─┘ ├───┬─┴─┐ ╷ ├─┬─┘ ┌───┤ └─┐ │
│  🐍│   │█│█ █│█ 🍒│🐍 🍌│█│█│█│█ █│  🐍│🍒  │ │
│ ┌─┴─┐ ╵ │ ╶─┤ ╷ ╵ ╷ ╵ │ ╵ │ ╶─┴─╴ ├─╴ │ │
│🍒│   │🍒 █│█ █│█│   │  🐍│█ █│█ █    │🐍  │🐍│
│ └─╴ └───┴─┐ │ └───┴───┴─┐ ├─────┐ │ ╶─┘ │
│    🐍 🐍 █ █│█│█   🍒     █│█│█ █  │ │  🍌 🍒│
├───╴ ┌───┐ ╵ ├─────┬───┐ │ ├─╴ ╷ │ └─┬───┤
│  🐍 🍌│🍌  │🍒  │    🐍│🐍  │ │ │  🐍│ │  🍌│   │
│ ╶─┬─┤ ╷ ├─╴ ╵ ┌─╴ │ ╷ │ │ ╵ ┌─┴─┼─╴ │ ╷ │
│   │ │ │🐍│🍌   🍌│  🐍│ │🍌│ │🍌  │  🍒│   │ │ │
├─╴ ╵ │ │ └─────┴─┐ ╵ ├─┘ ├───┘ ╷ ╵ ┌─┴─┘ │
│🍒    │ │█ █ █ █ █│█ █│█ █│█ █ █│  🐍│     │
│ ┌───┘ ├───┬───╴ ├───┘ ┌─┘ ┌───┴───┘ ┌─┐ │
│ │🍒    │█ █│█ █ █│█ █ █│█ █│█ █ 🐍    │🍌│🍌│
│ │ ┌───┤ ╶─┤ ╶───┤ ┌─╴ │ ╶─┘ ┌───────┤ ╵ │
│ │ │   │█ █│█ █ 🐍│🍒│   │█ █ █│█     🍒│  🍌│
├─┘ │ ╶─┘ ╷ ├───┐ │ └─┐ ├─────┤ ╶─┬───┤ ╶─┤
│🐍 🍌│🍌 🍒 █│█│█ █│ │  🐍│ │█ █ █│█  │  🍒│🍌 🍌│
│ ╶─┤ ┌───┤ ╵ ╷ ╵ │ ╷ │ └─┐ ╷ ╵ ╷ │ ╷ └─╴ │
│🐍 🍒│🍌│🐍 █│█ █│█ █│█│█│█ █│█│█ █│ │ │🍒 🍒 🐍│
├─╴ │ │ ╷ └───┴───┘ │ ├─┐ └─┼───┘ │ └─┬───┤
│   │🍌│🐍│█ █ █ █ █ █│█│█│█ █│█ █  │   │🐍  │
│ ┌─┘ ├─┴─────┬─────┘ │ ├─╴ ╵ ┌───┴─┐ └─┐ │
│🍌│   │  █ █ █│█   🍒  │ │█ █ █│█ 🐍  │  🍌│ │
│ │ ┌─┘ ┌───┐ ╵ ┌─────┤ ╵ ╶─┬─┘ ┌─┐ └─╴ │ │
│🍒│🐍│  🍒│█ █│█ █│  🐍  │🍒 █ █│█ █│ │🍒 🍒 🍒│ │
│ │ ╵ ┌─┘ ╶─┴───┤ ╶───┘ ┌───┘ ┌─┘ └─────┤ │
│🍌│   │  █ █ █ █│       │█ █ █│█ 🍒 🍒    │ │
│ └─┬─┘ ╶─┬─╴ ┌─┘ ╶─────┤ ╶───┴─────┐ ╷ ╵ │
│🍌  │🍒   █│█ █│█   🍒    │█ █ █ █    │ │🍒  │
├─╴ ├─────┘ ┌─┘ ┌─┬─────┴─────────┐ ╵ ├─╴ │
│🍒  │🍒     🐍│🍒  │ │  🍌 🍒 🍒 🍌   🍌  │   │   │
│ ┌─┘ ┌───╴ │ ╶─┤ │ ┌─────┬───┬─┐ └─┬─┘ ┌─┤
│🍌│   │  🐍 🍒│   │ │🍌│🍒 🐍  │🍒 🍌│🐍│   │🐍 🐍│🍌│
│ │ ╶─┤ ╶───┼─╴ ╵ │ └─┐ ╷ ╵ ╷ ╵ │ ╶─┤ ╶─┤ │
│🍒│🍒 🍒│🍒 █ █│█ █ 🍌│   │ │█ █│█ █│  🍒│   │🍌│
│ │ ╷ └─────┘ ┌───┴─┐ │ ├─┬─┘ ┌─┴─╴ └─┐ │ │
│ │🍌│🐍 🐍 █ █ █│█ 🐍 🍒│ │ │█│█ █│█ 🐍   🍒│🍌│🐍│
│ ├─┴─┬─────┬─┘ ┌─╴ │ ╵ │ ╵ ┌─┤ ┌─────┤ ╵ │
│🍒│   │  █ █│█ █│🐍  │🍒 🐍│█ █│█│█│🍌 🐍  │  🐍│
│ │ ╷ ╵ ┌─╴ │ ╶─┤ ╶─┴─┬─┘ ┌─┘ │ │ ╶─┐ ├─╴ │
│🐍│🍒│🍌 🍒│█ █│█ █│🐍   🐍│  █│█ █│█│🍒  │🐍│   │
│ ╵ ├─┬─┘ ╷ └─┐ └───┐ ╵ ┌─┘ ┌─┘ ├─╴ │ ╵ ┌─┤
│  🍒│ │🍒 █│█ █│█ 🍌 🍌│   │█ █│█ █│   │🍌 🐍│🐍│
│ ╶─┘ │ ┌─┴─╴ └───┐ └─┬─┴─╴ │ ╶─┤ ┌─┴───┘ │
│🍌    │ │█ █ █ █ 🍌│  🍒│🍌 █ █│█ █│ │🐍     🍒│
├─╴ ┌─┘ ├─────────┴─┐ │ ╶───┴─┐ ╵ │ ╷ ┌───┤
│  🍌│🍒 🐍│█ █ █ █ 🍌 🍒│🐍│🍒 █ █ █│█  │🍌│ │🐍  │
│ ╶─┤ ╶─┤ ╶───┬───┐ ╵ ├─────┐ └───┴─┤ ╵ ╷ │
│   │   │█ █ █│█ 🍌│🐍 🍒│  █ █│█ █   🍒│🍌  │ │
├───┴─╴ ├───┐ │ ╷ └───┘ ┌─╴ │ ╶─┐ ╷ └───┘ │
│    🍒  │█ █│█│█│█ █ █ █│█ █│█ █│🍌│  🍒 🐍  │
│ ╶─┬─╴ ╵ ╷ │ │ └───┬───┘ ┌─┴─┬─┘ ├─────┐ │
│   │  🐍 █│█│█│█ █ █│█ █ █│█ █│█ 🍒│🍒    │🍒│
│ ╷ └───┬─┴─┤ └───╴ │ ╶─┬─┘ ╷ │ ╷ │ ┌─╴ │ │
│ │     │🐍 🍌│  🐍 🐍 🐍│   │🍒  │🍌│ │ │ │  🍌│🍌│
│ ├───┐ ╵ ╷ └───┬───┴─┐ ╵ ┌─┘ │ ├─┘ │ ╶─┴─┤
│ │🍒 🐍│  🍌│🍌   🍌│    🐍│🐍 🐍│  🍌│ │   │🐍   🍌│
├─┘ ╷ └───┘ ┌─┐ │ ┌─╴ └───┤ ┌─┘ │ ┌─┴─┬─╴ │
│🍒 🍌│    █ █│█│█│█│  🐍 █ █│█│█ █│ │🐍  │   │
│ ┌─┼─────┬─┘ │ │ ├─────┐ │ │ ╷ │ ├─╴ │ ╷ │
│🍌│ │  🍒 🍒│🐍 🍌│🍌│█│🍒   █│ │ │🍒│█│🐍│🍌  │🐍│🍌│
│ │ ╵ ╶─┐ ╵ ╷ │ ╵ │ ┌─┐ └─┘ │ └─┤ │ ╷ │ │ │
│ │🐍    │█ █│█│█ █│🍌│🐍│█    │  █│ │ │ │🍒│ │
│ └─────┤ ╶─┤ ├─╴ │ ╵ ├─────┤ ╷ ╵ │ └─┤ │ │
│  🍌 🍌  │█  │ │   │🐍  │█ 🍌 🍌│ │█ 🐍│  🐍│ │🍌│
│ ┌───╴ ├───┘ │ ┌─┴─┐ ╵ ┌─╴ │ ├───┘ ╷ │ │ │
│ │     │█ █ █│█│█ 🍒│🍒 █│█ █│█│█   🍒│ │🍒│🐍│
├─┘ ┌───┘ ┌───┤ │ ╷ └───┘ ┌─┤ └─┐ ┌─┤ │ └─┤
│   │  🍌 🍌│  🍒│ │ │  🍒   🍌│ │🐍 🍒│ │🐍│ │🐍  │
│ ╶─┤ ╶───┘ ╷ ╵ │ └───┬─┬─┘ └─╴ │ ╵ │ └─┐ │
│   │    █ █│█ █│█ 🐍 🍒│█│█ █ █ █│   │🍌  │🍌│
│ ╷ ├───────┼───┴─┬─╴ │ │ ╶─┬───┼─╴ ├─╴ │ │
│ │🍌│  🐍    │    █│🐍  │█│   │🍒 █│   │🐍  │ │
│ │ │ ╶───┐ ╵ ┌─┐ │ ╶─┤ ├─╴ ╵ ╷ └───┘ ┌─┘ │
│ │ │🍌   █│█ █│█│█│🍌 🍒│█│🍌   🐍│█ 🍒   🍒│🐍 🍌│
│ │ └───╴ ├───┘ │ └─╴ │ ╵ ┌───┴─┬───╴ │ ╷ │
│🍒│  🍒   █│🍒    │🍌 🍒 🍌│█  │  🍒 █│🍒    │🍒│ │
│ └─┬─────┤ ┌─╴ └─┬───┴─┐ │ ┌─┐ ├─────┤ │ │
│  🐍│🍒   █│█│█ █ █│🍌 🍌 █│█│█│█│█│  🐍  │ │ │
├─╴ ╵ ┌─╴ └─┘ ┌─╴ └─╴ ╷ └─┘ │ ╵ ╵ ┌─╴ ╵ │ ╵
│🐍    │🐍     🐍│  🐍 🍌  │🐍    │  🐍  │🐍   🐍│  
└─────┴───────┴───────┴─────┴─────┴─────┴─╴
