                    
                    
    ############    
    ############    
    ####    ####    
    ####    ####    
    ############    
    ############    
    ####            
    ####            
    ####            
    ####            
                    
                    
    ####    ####    
    ####    ####    
    ####    ####    
    ####    ####    
    ############    
    ############    
        ####        
        ####        
        ####        
        ####        
                    
                    
    ############    
    ############    
    ####            
    ####            
    ####            
    ####            
    ####            
    ####            
    ############    
    ############    
                    
                    
    ############    
    ############    
    ####    ####    
    ####    ####    
    ####    ####    
    ####    ####    
    ####    ####    
    ####    ####    
    ############    
    ############    
                    
                    
    ####    ####    
    ####    ####    
    #####   ####    
    ######  ####    
    ############    
    ############    
    ####  ######    
    ####   #####    
    ####    ####    
    ####    ####    
                    
                    
    ############    
    ############    
    ####    ####    
    ####    ####    
    ############    
    ############    
    ####    ####    
    ####    ####    
    ####    ####    
    ####    ####    
                    
                    
    ####    ####    
    ####    ####    
    ####    ####    
    ####    ####    
    ####    ####    
    ####    ####    
    ####    ####    
    ####    ####    
    ############    
    ############    
                    
                    
    #####  #####    
        #  #   #    
    #####  #   #    
    #      #   #    
    #####  #####    
                    
    #####  #####    
        #  #   #    
    #####  #   #    
    #      #   #    
    #####  #####    
                    
